Andmebaas - База данных - Database
Andmebaasihaldur - администратор базы данных - Database administrator
Andmebaasi haldamise tarkvara - Программное обеспечение для управления базой данных - Software for database management
Kirje - Запись - Record
Väli - Поле - Field
Tabel - Таблица - Table
Päring - Запрос - Request
Veerg - Графа - Count
Rida - Строка - Line
Seosed - Связи - Connections
Piirangud - Ограничения - Restrictions
Primaarvõti - Первичный ключ - Primary key
Andmemudel - Модель данных - Data Model
Varukoopia - Резервная копия - Backup copy
Kasutusjuhend - Инструкция по применению - Instructions for use
Turvalisus - Безопасность - Safety
Kättesaadavus - Доступность - Availability
Andmete õigusus - Правосудие данных - Data Justice
Sisestusvorm - Форма ввода - Input form

--------------------------------------------
Näide - Пример - Example
Näidis - Образец - Sample
Sõltuvus - Зависимость - dependence
Seadustus - Законодательство - Legislation
Paigaldus - Установка - Installation
Hooldus - Уход  - Care
Lisamine - Добавление - Addition
Kustutamine - Удаление - Removal
Uuendamine - Обновление - Update
Sorteerimine - Сортировка - Sorting
Pärimine - Наследие - Heritage
Kasutaja - Пользователь - User
Kasutajate õigused - Права пользователей - User Rights
Haldamine - Управление - Control
Pästik - тригер - trigger
Käivita - Запустить - Launch
Salvesta - Сохранить - Save
Sisesta - Введите - Enter
Moodusa - режим - mode
laadi alla/laadi üles - скачать - download
Kävitatud päring - Отобранный запрос - Selected request
Salvestatud protseduur - Записанная процедура - Recorded procedure
Muutused - Изменения - Changes
Tõrketeade - Сообщение об ошибке - Error message 
Värskendus - Обновление - Update
